11111111
10000001
10001111
10000P11
1C0E1111
11111111
