111111111111
10PE0100CC01
10010100C001
10010100C001
1001010C0CC1
1001000CC0C1
111111111111
