111111111111
100E0101CC01
10000110CC01
10000100CC01
1000P00CC0C1
111111111111
