111111111111111111111111111111111111111111111111111111111111
100E0101CC0000000000000000110CC00000100CC00000110CC00000CC01
10000101CC0000000000000000110CC00000100CC00000110CC00000CC01
10000101CC0000000000000000110CC00000100CC00000110CC00000CC01
10000101CC0000000000000000110CC00000100CC00000110CC00000CC01
10000101CC0000000000000000110CC00000100CC00000110CC00000CC01
10000101CC0000000000000000110CC00000100CC00000110CC00000CC01
10000101CC0000000000000000110CC00000100CC00000110CC00000CC01
10000101CC0000000000000000110CC00000100CC00000110CC00000CC01
10000101CC0000000000000000110CC00000100CC00000110CC00000CC01
1000000CC0C00000000000000000000000000000000000000CC00000CC01
111111111111111111111111111111111111111111111111111111111111

