111111111111
100E0100CC01
10000100CC01
10000100CC01
1000P00CC0C1
111111111111
