111111111111
1EC0010H0101
1CC0000H0011
100101101001
10010011PC01
111111111111
