111111111111
1PC0E0000001
111111111111
