111111111111
1EC001000101
1CC000000011
100101101001
10010011PC01
111111111111
