111111111111111111111111111111111111111111111111111111111111
100E0101CC0000000000000000110CC00000100CC00000110CC00000CC01
10000101CC0000000000000000110CC00000100CC00000110CC00000CC01
10000101CC0000000000000000110CC00000100CC00000110CC00000CC01
10000101CC0000000000000000110CC00000100CC00000110CC00000CC01
10000101CC0000000000000000110CC00000100CC00000110CC00000CC01
10000101CC0011111111110000110CC00000100CC00000110CC00000CC01
10000101CC0000000000001000110CC00000100CC00000110CC00000CC01
10000101CC0000000000000100110CC00000100CC00000110CC00000CC01
10000101CC0000000000000010110CC00000100CC00000110CC00000CC01
100P000CC0C00000000000001000000000000000000000000CC00000CC01
111111111111111111111111111111111111111111111111111111111111
