11111111111111111111111111111111111111111111111111111111
1CCEC1C1CCCCCCCCCCCCCCCCCC11CCCCCCCC1CCCCCCCCC11CCCCCCC1
1CCCC1C1CCCCCCCCCCCCCCCCCC11CCCCCCCC1CCCCCCCCC11CCCCCCC1
1CCCC1C1CCCCCCCCCCCCCCCCCC11CCCCCCCC1CCCCCCCCC11CCCCCCC1
1CCCC1C1CCCCCCCCCCCCCCCCCC11CCCCCCCC1CCCCCCCCC11CCCCCCC1
1CCCC1C1CCCCCCCCCCCCCCCCCC11CCCCCCCC1CCCCCCCCC11CCCCCCC1
1CCCCCCCCCCCCCCCCCCCCCCCCCCCCCCCCCCCCCCCCCCCCCCCCCCCCCC1
1CCCC1C1CCCCCCCCCCCCCCCCCC11CCCCCCCC1CCCCCCCCC11CCCCCCC1
1CCCC1C1CCCCCCCCCCCCCCCCCC11CCCCCCCC1CCCCCCCCC11CCCCCCC1
1CCCC1C1CCCCCCCCCCCCCCCCCC11CCCCCCCC1CCCCCCCCC11CCCCCCC1
1CCPC1C1CCCCCCCCCCCCCCCCCC11CCCCCCCC1CCCCCCCCC11CCCCCCC1
11111111111111111111111111111111111111111111111111111111
