111111111111
10P00100CC01
100000000001
100101011101
10010001E001
111111111111
