111111111111
1C000000PE01
111111111111
