11111111111
100100C00C1
1C000111101
1P0011E0001
11111111111
