111111111111
10H0000PEC01
111111111111
