111111111111
1EC001000101
1CC0000H0011
100101101001
10010011PC01
111111111111
